anibal	password
mac	dustups
kristin	password
hal	darkle
norberto	durhams
fred	annam
elvie	systemics
sierra	merlyn
glynda	alabaster
emanuel	password
kelley	password
rich	password
carline	allegedly
berry	keeper
echo	predict
ned	durhams
hans	absenting
kirk	behooving
roosevelt	draw
reggie	password
andre	password
derick	hauptmann
wiley	reboots
sibyl	reboots
lorriane	keeper
emmanuel	sampans
victoria	aortic
rosalee	mercuric
leonila	cobain
garland	molehills
charleen	amiss
elmira	amiss
shane	creel
jon	alabaster
chance	sampans
alden	hauptmann
riley	limpidity
nathanael	absenting
katina	coasting
roy	merlyn
jackson	predict
linwood	draw
jamison	allegedly
trudi	aortic
gregorio	molehills
vesta	password
mitzi	cobain
roselle	password
delicia	password
geneva	limpidity
